00000000000000000000000000000000000000000000000000000000000000000000000
03333333333333333333333333333333333333333333333333333333333333333333330
01111111111111111111111111111111111111111111111111111111111111111111110
02222222222222222222222222222222222222222222222222222222222222222222220
02222222222222222222222222222222222222222222222222222222222222222222220
01111111111111111111111111111111111111111111111111111111111111111111110
03333333333333333333333333333333333333333333333333333333333333333333330
00000000000000000000000000000000000000000000000000000000000000000000000